xxxxxxxxxxxxxxxx
x  xs    x   xsx
xx xs  x   x   x
x sxfxxxxxxx  sx
x xxxxs    x   x 
xs   x  x sx  sx
xxx  x  xs x   x
xs   x xx sx   x
xxx  xs xs x  sx
xv   xx x sx   x
xss     xs     x
xxxxxxxxxxxxxxxx