xxxxxxxxxxxxxxxx
x            vsx
x              x
x ss v    v    x
x          v v x
x        v  s  x
x    v      v sx
x             sx
x s  v  s      x
x s  v  s      x
x             fx
xxxxxxxxxxxxxxxx